¨€¨€¨€¨€¨€¨€¨€¨€¨€¨€¨€¨€¨€¨€¨€¨€¨€¨€¨€¨€¨€¨€¨€¨€¨€¨€¨€¨€¨€¨€¨€¨€¨€¨€¨€¨€¨€¨€¨€
¨€¡â¡¡¨€¨€¡¡¡¡¡¡¡¡¡¡¨€¨€¨€¨€¨€¨€¨€¨€¨€¨€¨€¨€¨€¨€¡¡¡¡¡¡¨€¨€¨€¨€¨€¨€¨€¨€¨€¨€¨€¨€
¨€¨€¡¡¡¡¨€¡¡¨€¡¡¨€¡¡¡¡¡¡¡¡¡¡¡¡¨€¡¡¡¡¡¡¡¡¨€¨€¨€¡¡¡¡¨€¡¡¡¡¨€¨€¡¡¡¡¡¡¨€¡¡¡¡¡¡¨€¨€
¨€¡¡¡¡¨€¡¡¡¡¨€¡¡¡¡¨€¡¡¨€¨€¨€¡¡¨€¡¡¨€¨€¡¡¡¡¡¡¡¡¨€¨€¡¡¨€¡¡¡¡¡¡¡¡¨€¡¡¡¡¡¡¨€¡¡¨€¨€
¨€¡¡¨€¡¡¡¡¨€¡¡¨€¡¡¨€¡¡¡¡¡¡¨€¡¡¡¡¡¡¡¡¡¡¨€¡¡¨€¡¡¡¡¨€¡¡¡¡¡¡¨€¨€¡¡¡¡¨€¨€¨€¨€¡¡¨€¨€
¨€¡¡¡¡¨€¡¡¡¡¡¡¨€¡¡¨€¨€¨€¡¡¡¡¨€¨€¨€¨€¡¡¨€¡¡¡¡¨€¡¡¨€¡¡¨€¨€¡¡¡¡¨€¡¡¨€¡¡¡¡¡¡¡¡¨€¨€
¨€¨€¡¡¡¡¨€¡¡¨€¨€¡¡¡¡¡¡¡¡¨€¡¡¡¡¡¡¡¡¨€¡¡¡¡¨€¡¡¨€¡¡¨€¡¡¡¡¡¡¨€¡¡¡¡¡¡¨€¡¡¨€¡¡¨€¨€¨€
¨€¡¡¡¡¨€¡¡¡¡¡¡¨€¡¡¨€¨€¡¡¡¡¨€¡¡¨€¡¡¡¡¨€¨€¡¡¡¡¨€¡¡¡¡¡¡¨€¡¡¨€¡¡¨€¡¡¨€¡¡¨€¨€¡¡¡¡¨€
¨€¡¡¨€¡¡¡¡¨€¡¡¨€¡¡¨€¨€¨€¡¡¨€¡¡¨€¨€¡¡¡¡¡¡¨€¡¡¡¡¨€¨€¨€¡¡¡¡¡¡¨€¡¡¡¡¨€¡¡¡¡¡¡¨€¡¡¨€
¨€¡¡¡¡¨€¡¡¨€¡¡¨€¡¡¡¡¨€¡¡¡¡¨€¡¡¡¡¡¡¨€¨€¡¡¡¡¨€¨€¡¡¡¡¡¡¨€¨€¡¡¡¡¨€¡¡¡¡¨€¨€¡¡¡¡¡¡¨€
¨€¨€¡¡¨€¡¡¡¡¨€¡¡¨€¡¡¨€¡¡¨€¨€¨€¨€¡¡¡¡¡¡¨€¡¡¡¡¡¡¡¡¨€¡¡¡¡¨€¡¡¨€¡¡¨€¡¡¡¡¨€¡¡¨€¨€¨€
¨€¨€¡¡¡¡¨€¡¡¡¡¡¡¡¡¨€¡¡¡¡¡¡¨€¡¡¡¡¡¡¨€¨€¡¡¨€¡¡¨€¡¡¨€¡¡¨€¡¡¡¡¡¡¡¡¡¡¨€¡¡¨€¨€¨€¨€¨€
¨€¨€¨€¡¡¡¡¨€¡¡¨€¨€¨€¡¡¨€¡¡¨€¡¡¨€¨€¡¡¡¡¡¡¡¡¨€¡¡¡¡¨€¡¡¡¡¨€¨€¡¡¨€¨€¡¡¨€¡¡¡¡¡¡¨€¨€
¨€¨€¨€¨€¡¡¨€¡¡¨€¡¡¡¡¡¡¨€¨€¡¡¡¡¨€¡¡¡¡¨€¨€¡¡¡¡¨€¡¡¨€¡¡¨€¡¡¡¡¡¡¨€¡¡¡¡¡¡¡¡¨€¡¡¨€¨€
¨€¨€¡¡¡¡¡¡¨€¨€¡¡¡¡¨€¡¡¨€¨€¡¡¨€¡¡¡¡¨€¡¡¡¡¨€¡¡¨€¡¡¨€¡¡¨€¡¡¨€¨€¡¡¡¡¨€¡¡¨€¡¡¡¡¨€¨€
¨€¨€¡¡¨€¡¡¡¡¡¡¡¡¨€¨€¨€¡¡¡¡¡¡¨€¡¡¨€¨€¨€¡¡¡¡¡¡¨€¨€¡¡¡¡¨€¡¡¡¡¨€¡¡¨€¡¡¡¡¨€¡¡¨€¨€¨€
¨€¨€¡¡¡¡¨€¨€¨€¡¡¨€¨€¡¡¡¡¨€¨€¡¡¨€¨€¡¡¡¡¨€¨€¡¡¡¡¨€¡¡¨€¨€¨€¨€¡¡¡¡¨€¡¡¨€¡¡¡¡¨€¨€¨€
¨€¨€¡¡¨€¡¡¡¡¡¡¨€¡¡¡¡¡¡¨€¨€¡¡¡¡¡¡¡¡¡¡¨€¡¡¡¡¡¡¨€¡¡¡¡¨€¨€¡¡¡¡¡¡¨€¡¡¡¡¨€¡¡¨€¨€¨€¨€
¨€¨€¡¡¡¡¡¡¨€¡¡¨€¡¡¨€¨€¡¡¡¡¡¡¨€¡¡¨€¨€¡¡¡¡¨€¨€¡¡¡¡¨€¡¡¡¡¡¡¨€¨€¡¡¡¡¨€¨€¡¡¡¡¡¡¨€¨€
¨€¨€¨€¨€¨€¡¡¡¡¨€¡¡¡¡¡¡¡¡¨€¡¡¨€¡¡¡¡¡¡¡¡¨€¡¡¨€¡¡¨€¡¡¡¡¨€¨€¡¡¨€¡¡¨€¡¡¡¡¡¡¨€¡¡¡¡¨€
¨€¨€¡¡¡¡¨€¡¡¨€¡¡¨€¨€¨€¨€¡¡¨€¡¡¨€¨€¨€¡¡¨€¡¡¡¡¡¡¨€¡¡¨€¡¡¨€¡¡¡¡¡¡¨€¡¡¨€¨€¡¡¨€¡¡¨€
¨€¨€¡¡¨€¨€¡¡¡¡¡¡¡¡¡¡¡¡¡¡¡¡¡¡¡¡¨€¡¡¨€¡¡¨€¡¡¨€¨€¡¡¡¡¨€¡¡¨€¨€¨€¨€¡¡¡¡¡¡¡¡¡¡¨€¡¡¨€
¨€¨€¡¡¡¡¡¡¡¡¨€¨€¨€¨€¨€¨€¨€¨€¨€¨€¡¡¡¡¡¡¨€¡¡¡¡¡¡¡¡¨€¨€¡¡¡¡¡¡¡¡¡¡¡¡¨€¨€¨€¨€¨€¡ï¨€
¨€¨€¨€¨€¨€¨€¨€¨€¨€¨€¨€¨€¨€¨€¨€¨€¨€¨€¨€¨€¨€¨€¨€¨€¨€¨€¨€¨€¨€¨€¨€¨€¨€¨€¨€¨€¨€¨€¨€