██████████████
█♀█　　　　　　　　　　█
█▓████　█　█████
█　　　　█　█　　　　　█
██　█　█　█　███　█
█　　█　█　█　　　█　█
█　██　█　███　█　█
███▓▓　　█☉█☉█　█
█　　　████　███　█
█　██　　　█　　　　　█
█　█　　█　███████
█　　　██　　　　☉█★█
██████████████
#k e9,8 11,12
#k e11,8 12,12
#k w11,12 8,12 12,12
#p 2,3 不要偷懒
#p 4,8 这边是终点
#p 5,8 我不骗你